10 10
1111111111
1010210001
1000110101
1101100101
1001001101
1011100101
1001001101
1100011003
1001000011
1111111111
